44444444444444
48888888888884
48888888877774
48888888888884
48888777888884
48888888878884
48888888788884
48888887888884
48888878888884
48888888888884
48887777788784
48888888887884
48888888878884
48888888788884
48888887888884
48887888888884
48888788888884
48888878888884
48888887888774
48888888887884
48888888878884
48888888788884
48888877888884
48878888888884
48887888888884
48888788888884
48888878888884
48888887888884
48888888877884
48888888788884
48888887888884
48888878888884
48888788888884
48788888888884
48877788888884
48888877888884
48888888788884
48888888878884
48888888887884
48888888888784
48888888888884
44444444444444